R 1920 1080
NO ./pics/eagle.png 
SO ./pics/mossy.png
WE ./pics/wood.png
EA ./pics/brick.png
S ./pics/pillar.png
F 2,241, 4
C 225,30,0

    11111
   1000001    
   1022001           1111111111
   1000001           10001110S111
   100000111111111111100000000001
   10000000000000000000000011111111
   1002001111111100011111111001
1111000001      10001      1001
1000000001      11011      1111
1111002001       101
   1000001      11011
   1000001      1000111111111
    11111      11011          
                 101
                 101
                 101
         1111111111111111