R 600 600
NO ./pics/redbrick.png
SO ./pics/mossy.png
WE ./pics/eagle.png
EA ./pics/colorstone.png
S ./pics/barrel.png
F 66, 66, 66
C 200,200,200
                                        1111111111111111111111111111111
 1111111111111111111111111111           1000000000200000000000200000001
10000111111100100000000000000111111111111000000000000000000000000000001
10000000000000100000000000000000000000000000000000000000000000000000001
10000000000001000000000000001111000000001111111111111111111111111111101
10000000000010000000000000001  1000000001                           101
10000000000E00000000000000001111000000001111111111111               101
11111111111000000000001000000000000000000000000000001               101
10000000000000000000000000001111000000001111111111101               101
10000000000000000000000000001  1000000001         101               101
10000000000200000020000000001  1111111111         101               101
10000000000200000020000000001        11111111111111011111111        101
10000000000200000020011111111        10000000000000000000001        101
1000000000020000002001               10000000000000000000001        101
1000000000020000002001               10000000000000000000001        101
1111111111111111111111               10000000000000000000001        101
                                     10000000000000000000001        101
                                     10000000222222220000001        101
                                     10000000000000000000001        101
                                     10000000000000000000001        101
                                     1111111111111111101111111111111101
                                                     100000000000000001
                                                     111111111111111111